%Unidade 1
red: vermelho
boy: garoto, menino
house: casa
about: sobre
all: todos
and: e
as: como
at: em
be: estar
because: porque
but: mas
by: de
can: posso
come: venha
could: poderia
day: dia
do: faz
even: ate
find: encontrar
first: primeiro
for: para
from: de
get: pegue
give: dar
go: ir
have: ter
he: ele
her: dela
here: aqui
him: ele
his: dele
how: quao
in: dentro
it: isto
just: somente
know: conhecer
like: gostar
look: veja
%Unidade 2
apple: maca
home: casa, lar
computer: computador, pc